R 1200 800
NO ./textures/north.xpm
SO ./textures/south.xpm
WE ./textures/west.xpm
EA ./textures/east.xpm
S ./textures/sprite.xpm
F 184,113,3a9
C 51,198,227

11111111111111111111111111111
11111000000000000000000000001
10000000000000000000000000001
10000000000000000000000000001
10000000000000E20200000000001
11000000000000000000000000001
10000000000000000000200000001
11111111111111111111111111111
순서체크
해상도 색에 숫자외에 다른것들
중간 엠티라인
숫자사이에 공백올때
해상도나 색상의 갯수가 오버될때
색상 쉼표 여러개일때