R 1080 700
NO ./textures/north.xpm
SO ./textures/south.xpm
WE ./textures/west.xpm
EA ./textures/east.xpm
S ./textures/sprite_1.xpm
F 184,113,39
C 51,198,227

11111
1S001
11111

