R 1080 700
NO ./textures/north.xpm
SO ./textures/south.xpm
WE ./textures/west.xpm
EA ./textures/east.xpm
S ./textures/sprite.xpm
F 184,113,39
C 51,198,227

        1111111111111111111111111
        1000000000110000000000001
        1011000001110000002000001
        1001000000000000000000001
111111111011000001110000000000001
100000000011000001110111111111111
11110111111111011100000000001
11110111111111011101010000001
11000000110101011100000000001
10002000000000001100000000001
10000000000000001101010000001
1100000111010101111101110000111
11110111 1110101 101111000N01
11111111 1111111 111111111111

