R 1200 800
NO ./textures/north.xpm
SO ./textures/south.xpm
WE ./textures/west.xpm
EA ./textures/east.xpm
S ./textures/sprite.xpm
F 184,113,39
C 51,198,227









11111111111111111111    
1111100000000000000111111111
100000000000000000000001
100000000000000000000001   
10000000000000E202000001
110000000000000000000001
100000000000000000002001
111111111111111111111111